000000000000000
0P0000000000000
011110000000100
000011111111100
000010000000000
000010000000000
000011111111100
000000001000100
000010001000110
000010001000010
000011111001110
000000001001000
000000001001100
000000000000100
0    0000000E00